11111111111111111111
1P0000000000110000C1
10111101111101111101
1C000001000000000001
10001110101110111001
1C0000000100000000E1
10111011111101111101
10000000000000000001
1C011101110111011101
11111111111111111111
