111111
1P0C01
100001
1C0E01
100000
111111