1111111
1P000C1
1111101
1C0E001
1111001
1111111