111111
1P0E01
111001
1C1C11
100001
111111